time 30

###########################
#**    1           2    **#
#*# # #x# # # # # #x# # #*#
#                         #
# # # # # # # # # # # # # #
#                         #
# # # # # # # # # # # # # #
#                         #
# # # # # # # # # # # # # #
#                         #
# # # # # # # # # # # # # #
#       2          1      #
#*# # #x# # # # # #x# # #*#
#**                     **#
###########################