time 120

##############
#**        **#
#*          *#
#            #
#            #
#            #
#            #
#            #
#            #
#            #
#            #
#            #
#*          *#
#**        **#
##############
