time 40

#############
#**  x#x  **#
#*# #2#2# #*#
#   # # #   #
# # # # # # #
#           #
# # # # # # #
#           #
#*# # # # #*#
#**1x #1x **#
#############