time 100

##############
#**    1   **#
#*# # #x# #*##
#            #
# # # # # #  #
#            #
# # # # # # ##
#            #
# # # # # #  #
#            #
# # # # # #  #
#      1     #
#*# # #x# #*##
#**        **#
##############